80 40 0	 240 40 0  440 40 0  640 40 0  840 40 0 360 80 3 
80 80 0  240 160 0 600 80 2  640 80 0  840 480 0 120 400 3  
80 120 0 240 240 0 440 520 0 640 120 0 840 560 0 600 400 3 
80 160 0 240 360 0 440 680 0 640 160 0 840 600 0 560 560 3 
80 200 0 240 440 0 480 40 0  640 200 0 840 680 0 560 640 3 
80 240 0 240 520 0 480 80 0            880 40 0  840 80 3 
80 280 0 240 680 0 480 120 0 640 280 0 880 280 0 120 640 4  
80 320 0 280 40 0  480 160 0 640 320 0 880 480 0 760 80 4  
80 360 0 280 160 0 480 280 0 640 360 0 880 560 0 880 80 4 
80 400 0 280 240 0 480 320 0 640 400 0 880 680 0 440 80 4 
80 440 0 280 360 0 480 360 0 640 440 0  920 40 0 320 640 5 
80 480 0 280 440 0 480 400 0 640 680 0  920 80 0 
80 520 0 280 520 0 480 440 0 680 40 0   920 120 0  
80 560 0 280 680 0 480 520 0 680 680 0  920 160 0 
80 600 0 320 40 0  480 680 0  720 40 0  920 200 0 
80 640 0 320 160 0  520 40 0  720 80 0  920 240 0 
80 680 0 320 240 0  520 160 0 720 120 0 920 280 0  
120 40 0 320 360 0  520 280 0 720 160 0 920 480 0 
120 360 0 320 520 0 520 440 0 720 200 0 920 560 0  
120 440 0 320 680 0 520 520 0 720 240 0 920 600 0  
120 680 0 360 40 0  520 680 0 720 280 0 920 680 0  
160 40 0  360 240 0 560 40 0  720 400 0 960 40 0 
160 80 0  360 360 0 560 160 0 720 440 0 960 480 0 
160 120 0 360 400 0 560 280 0 720 480 0 960 680 0
160 160 0 360 440 0 560 360 0 720 520 0 1000 40 0
160 240 0 360 520 0 560 440 0 720 560 0 1000 80 0
160 360 0 360 600 0 560 520 0 720 600 0 1000 120 0
160 440 0 360 640 0 560 680 0 720 680 0 1000 160 0
160 520 0 360 680 0 600 40 0  760 40 0  1000 200 0
160 680 0 400 40 0  600 360 0 760 280 0 1000 240 0
200 40 0  400 80 0  600 440 0 760 400 0 1000 280 0
200 160 0 400 120 0 600 520 0 760 440 1 1000 320 0
200 240 0 400 160 0 600 560 0 760 600 0 1000 360 0
200 360 0 400 200 0 600 600 0 760 680 0 1000 400 0 
200 440 0 400 240 0 600 640 0 800 40 0  1000 440 0 
200 520 0           600 680 0 800 280 0 1000 480 0 
200 680 0 400 680 0 800 600 0 800 400 0 1000 520 0 
360 480 0           800 680 0 800 440 0 1000 560 0 
                              800 480 0 1000 600 0 
                             1000 680 0 1000 640 0 