0 0 0  40 0 0   320 0 0   760 0 0  1000 0 0   
0 40 0 40 240 0 320 160 0 760 40 0  1000 40 0
0 80 0 40 640 0 320 240 0 760 80 0  1000 80 0
0 120 0 80 0 0   320 320 0 760 160 0 1000 120 0
0 160 0 80 240 0 320 360 0 760 200 0 1000 160 0
0 200 0 80 320 0 320 400 0 760 240 0 1000 200 0
0 240 0 80 360 0 320 440 0 760 280 0 1000 240 0
0 280 0 80 400 0 320 480 0 760 320 0 1000 280 0
0 320 0 80 440 0 320 520 0 760 360 0 1000 320 0
0 360 0 80 480 0 320 640 0 760 400 0 1000 360 0
0 400 0 80 520 0 360 0 0   760 440 0 1000 400 0
360 160 0 360 240 0        760 480 0 1000 440 0
0 440 0 80 640 0 360 320 0 760 520 0 1000 480 0
0 480 0 120 0 0  360 520 0  760 560 0 1000 520 0
0 520 0 120 240 0 360 640 0 760 600 0 1000 560 0
0 560 0 120 320 0  400 0 0  760 640 0 1000 600 0
0 600 0 120 520 0  400 40 0          1000 640 0
0 640 0 120 640 0  400 120 0 360 200 3 120 360 3
160 0 0   240 0 0  400 160 0 800 0 0 640 280 3 
160 240 0 240 160 0 400 200 0 800 640 0 600 480 3   
160 320 0 240 240 0 400 240 0 840 0 0 80 40 4 
160 520 0 240 320 0 400 320 0 840 40 0 640 40 4 
160 640 0 240 360 0 400 520 0 840 80 0 960 520 4 
200 0 0   240 400 0 400 640 0 840 120 0 880 320 4 
200 40 0  240 480 0 440 0 0  840 160 0  360 360 5 
200 120 0 240 520 0 440 320 0 840 200 0 120 480 2 
200 160 0 240 640 0 440 360 0 840 240 0 800 40 5 
200 240 0 280 0 0   440 400 0 840 280 0 
200 320 0 280 160 0 440 480 0 840 320 0 
200 520 0 280 240 0 440 520 0 840 360 0 
200 640 0 280 640 0 440 640 0 840 400 0
480 0 0 480 640 0 680 0 0     840 480 0
520 0 0  560 0 0  680 200 0   840 520 0
520 40 0 560 200 0 680 240 0  840 560 0
520 80 0 560 320 0 680 280 0  840 600 0
520 120 0 560 440 0 680 320 0 840 640 0
520 160 0 560 560 0 680 440 0 880 0 0
520 200 0 560 640 0 680 480 0 880 200 0
520 240 0 600 0 0   680 520 0 880 640 0
520 280 0 600 320 0 680 560 0 920 0 0
520 320 0 600 440 0 680 640 0 920 80 1
520 440 0 600 640 0 720 0 0   920 640 0
520 480 0 640 0 0  720 640 0 
520 520 0 640 200 0 960 0 0         
520 560 0 640 320 0 960 200 0
520 600 0 640 440 0 960 640 0
520 640 0 640 560 0
         640 640 0
